{
    "debug": {
	"map": [
	    "######################",
	    "#N...................#",
	    "#....................#",
	    "#....................#",
	    "#....................#",
	    "#....................#",
	    "#....................#",
	    "#....................#",
	    "#....................#",
	    "######################"
	],
	"triggers": [
	    {"x": 1, "y": 1, "command": "load next"}
	],
	"teacher": {"x": 5, "y": 1, "subject": "math"},
	"init": {"x": 5, "y": 5}
    },
    "next": {
	"map": [
	    "####################",
	    "#D.................#",
	    "#L.................#",
	    "####################"
	],
	"triggers": [
	    {"x": 1, "y": 1, "command": "load debug"},
	    {"x": 2, "y": 1, "command": "load library"}],
	"init": {"x": 5, "y": 1}
    },
    "library": {
    	"map": [
    	    "##########",
    	    "#........#",
    	    "#........#",
    	    "#........#",
    	    "#........#",
    	    "##########"
    	],
    	"triggers": [
    	    {"x": 1, "y": 1, "command": "load next"}
    	],
    	"init": {"x": 5, "y": 1}
    }
}
