{
    "cor1": {
	"map": [
	    "######################",
	    "#N...................#",
	    "#....................#",
	    "#....................#",
	    "#....................#",
	    "#....................#",
	    "#....................#",
	    "#....................#",
	    "#....................#",
	    "######################"
	],
	"triggers": [
	    {"x": 1, "y": 1, "command": "load cor2"}
	],
	"teacher": {"x": 5, "y": 1, "subject": "math"},
	"init": {"x": 5, "y": 5}
    },
    "cor2": {
	"map": [
	    "####################",
	    "#DL................#",
	    "#..................#",
	    "####################"
	],
	"triggers": [
	    {"x": 1, "y": 1, "command": "load cor1"},
	    {"x": 2, "y": 1, "command": "load library"}],
	"init": {"x": 5, "y": 1}
    },
    "library": {
    	"map": [
    	    "##########",
    	    "#N.......#",
    	    "#........#",
    	    "#........#",
    	    "#........#",
    	    "##########"
    	],
    	"triggers": [
    	    {"x": 1, "y": 1, "command": "load cor2"}
    	],
    	"init": {"x": 5, "y": 1}
    }
}
